R 1000    1000
F 228,233,237
NO     xpm-img/brick.xpm
SO  xpm-img/brick.xpm
WE xpm-img/bars.xpm
EA xpm-img/bars.xpm

C 149, 165   , 166
S xpm-img/Sarko.xpm

            111111111111111111111111111
            100000100010000000000000001
            100000100010000020000000001
            100000100010000000000000001
            100000000000000000022200001
111111111111100000000000000000000000001
10000000000000000000000S000000000000001
100000200000000000000000000000000000001
100000200001111111110011111111111111111
100000000001       1001
100000000001       1001
100000000001       1001
100020000001       1001
100020000001111111110011111111111111
100000000000000000000000000001000001
111111111110000000002000000001000001
          11000000000000000000100001
           1100002200000200000000001
            100000000000000000000001
            100000000000000000000001
            100000000000000002000001
            100000000200000000000001
            100000000000000000000001
            111111111100111111111111
                     1001
                     1001
                     1001
                     1001
            111111111100111111111111
            100000000000000000000001
            100000000000000000000001
            100000000000000000000001
            100000000010000000000001
            100000000000000000000001
            111111111111111111111111
            11111
