R 1000 800
F 165,89,89
C 0,224,224


    11111111111111111111111
    10000000000000000000001
111110000000000000000001111
10000000000000000000000001
10000022222000000000000111
10000020002000000000000111
10000020002000000000000001
10000020002000000000000111
100000220220000000000001
100000000000000000000001
100000000000000000000001
100000000000000000000001
100000000000000000000001
100000000000000000000001
100000000000000000000001
100000000000000000000001
100000000000000000000001
100000002000000000000001
100000E02000000000000001
100000002000000000000001
100000000000000000000001
100000000000000000000001
100000000000000000000001
111111111111111111111111
