R 1000 800
F 165,89,89
C 0,224,224


 1 1111111111111111111111111
  11100000000000000000000011
1111100000000000000000011111
10000000000000000000000001
10000022222000000000000111
10000020002000000000000111
10000020002000000000000001
10000020002000000000000111
100000220220000000000001
100000000000000000000001
100000000000000000000001
100000000000000000000001
100000000000000000000001
100000000000000000000001
100000000000000000000001
100000000000000000000001
122222222000000000000001
120200002000000000000001
120000W02000000000000001
120200002000000000000001
120222222000000000000001
120000000000000000000001
122222222000000000000001
111111111111111111111111
