R 1000 800
  
11111111111111111111111
100000000000000000000001
100000000000000000000001
100000000000000000000001
100000222220000000000001
100000200020000000000001
100000200020000000000001
100000200020000000000001
100000220220000000000001
100000000000000000000001
100000000000000000000001
100000000000000000000001
100000000000000000000001
100000000000000000000001
100000000000000000000001
100000000000000000000001
122222222000000000000001
120200002000000000000001
120000W02000000000000001
120200002000000000000001
120222222000000000000001
120000000000000000000001
122222222000000000000001
111111111111111111111111
