R 1000 800
F 165,89,89
C 0,224,224


111111111111111111111111111
100000000000000000000000001
111110000000000000000000001
100000000000000000000000001
100000222220000000000000001
100000200020000000010000001
100000200020000000010000001
100000200020000000011111111
100000220220000000000001
100000000000000000000001
100000000000000000000001
100000000000000000000001
100000000000000000000001
100000000000000000000001
100000000000000000000001
111111101111111111111111
111111101
100000001
1001111111
1W1111111111111
100000000000001
101111111111111
101
111
