R 1000 800
F 235, 151,78
C 1,204,181
 
            111111111111111111111111111
            100000100010000000000000001
            100000100010000000000000001
            100000100010000000000000001
            100000200020000000000000001
111111111111100000000000000000000000001
100000000000000000000000000000000000001
100000200000000000000000000000000000001
100000200001111111111111111111111111111
100000000001
100000000001
100000000001
100000000001
100000000001111111111111111111111111
100000000000000000000000000001000001
111111111110000000000000000001000001
          11000000000000000000100001
           110000000000E000000000001
            100000000000000000000001
            100000000000000000000001
            100000000000000000000001
            100000000000000000000001
            100000000000000000000001
            111111111100111111111111
                     1001
                     1001
                     1001
                     1001
            111111111100111111111111
            100000000000000000000001
            100000000000000000000001
            100000000000000000000001
            100000000000000000000001
            100000000000000000000001
            111111111111111111111111
            11111