R 1980    1000
F 235, 151,78
NO     ./wall_white.xpm
SO    ./greystone.xpm
WE ./purplestone.xpm
EA ./redbrick.xpm

C 1,204,181
S ./barrell.xpm
            111111111111111111111111111
            100000100010000000000000001
            100000100010000000000000001
            100000100010000000000000001
            100000200020000000022200001
111111111111100000000000000000000000001
100000000000000000000000000000000000001
100000200000000000000000000000000000001
100000200001111111111111111111111111111
100000000001
100000000001
100000000001
100000000001
100000000001111111111111111111111111
100020000000000000000000000001000001
111111111110000000002000000001000001
          1100000000000000N000100001
           1100002200000000000000001
            100000000000000000000001
            100000000000000000000001
            100000000000000002000001
            100000000200000000000001
            100000000000000000000001
            111111111100111111111111
                     1001
                     1001
                     1001
                     1001
            111111111100111111111111
            100000000000000000000001
            100000000000000000000001
            100000000000000000000001
            100000000000000000000001
            100000000000000000000001
            111111111111111111111111
            11111