R 1000 800
F 165,89,89
C 0,224,224


111111111111111111111111111
100000000000000000000000001
111110000000000000000000001
100000000000000000000000001
100000222220000000000000001
100000200020000000010000001
100000200020000000010000001
100000200020000000011111111
100000220220000000000001
100000000000000000000001
100000000000000000000001
100000000000000000000001
100000000000000000000001
100000000000000000000001
100000000000000000000001
100111111111111111111111
100000000000000000000001
100111111111111111111111
100000001000000000000001
100000W01000000000000001
100000000000000000000001
100000000011111111111111
100000000000000011111111
1111111111111111111
