R 1900 1900
F 179, 59,0
NO     xpm-img/bookshelf.xpm
SO  xpm-img/bookshelf.xpm
WE xpm-img/bookshelf.xpm
EA xpm-img/wood.xpm

C 1,42,37
S xpm-img/barrel.xpm
            111111111111111111111111111
            100000100010000000000000001
            100000100010000000000000001
            100000100010000000000000001
            100000200020000000022200001
111111111111100000000000000000000000001
10000000000000000000000N000000000000001111111111111
100000200000000000000000000000000000000000000000001
100000200001111111110011111111111111111111111111101
100000000001       1001                         101
100000000001       1001                         101
100000000001       1001                         101
100000000001       1001                         101
100000000001111111110011111111111111            101
100000000000000000000000000001000001            101
111111111110000000002000000001000001            101
          11000000000000000000100001            101
           1100002200111111000000001            101
            1000000001    1000000001            101
            1000000001    1000000001            101
            1000000001    1002000001            101
            100000000111111000000001            101
            100000000000000000000001            101
            111111111100111111111111            101
                     1001                       101
                     1001                       101
                     1001                       101
                     1001                       101
            111111111100111111111111            101
            100000000000000000000001            101
            100000000000000000000001            101
            100000000000000000000001            101
            100000000010000000000001            101
            100000000000000000000001            101
            111111111111111111011111111111111111101
            11111            1000000000000000000001
            111111111111111111111111111111111111111