R 1900 1900
F 150, 40,27
NO     xpm-img/bookshelf.xpm
SO  xpm-img/bookshelf.xpm
WE xpm-img/bookshelf.xpm
EA xpm-img/wood.xpm

C 1,42,37
S xpm-img/barrel.xpm
            111111111111111111111111111
            100000100010000000000000001
            100000100010000000000000001
            100000100010000000000000001
            100000000000000000000000001
111111111111100000000000000000000000001
100000000000000000000W00000000000000001111111111111111
100000000000000000000000000000000000000000000000000001
100000000001111111110011111111111111111111111111111101
100000000001       1001                            101
100000000001       1001                            101
100000000001       1001                            101
100000000001       1001                            101
100000000001111111110011111111111111               111
100000000000000000000000000001000001
111111111110000000000000000001000001
          11000000000000000000100001
           1100000000000000000000001
            1000000000000000000000011111111111111111111
            1000000000000000000000000000000000000000001
            1000000000000000000000011111111111111111101
            1000000000000000000000011               101
            1000000000000000000000001111111111111111101
            1111111111001111111111100000000000000000001
                     1001         111111111111111111111
                     1001
                     1001
                     1001
            111111111100111111111111
            100000000000000000000001
            100000000000000000000001
            100000000000000000000001
            100000000010000000000001
            100000000000000000000001
            111111111111111111111111
            11111
